0 1 2 0 0 0 0 0 3 4
0 1 2 0 0 0 0 5 1 2
6 7 8 6 6 6 6 6 9 2
0 0 10 11 12 13 0 0 1 2
0 10 14 15 15 16 13 17 1 2
10 14 18 19 20 21 16 13 1 2
22 23 24 24 24 24 25 26 1 2
0 27 28 29 29 28 30 0 1 2
0 0 31 32 32 31 0 33 1 2
6 6 8 6 6 8 6 6 34 35
