0 79 80 0 0 0 0 0 81 82
0 79 80 0 0 0 0 83 79 80
84 85 86 84 84 84 84 84 87 80
0 0 88 89 90 91 0 0 79 80
0 88 92 93 93 94 91 95 79 80
88 92 96 97 98 99 94 91 79 80
100 101 102 102 102 102 103 104 79 80
0 105 106 107 107 108 109 0 79 80
0 0 110 111 111 110 0 112 79 80
84 84 86 84 84 86 84 84 113 114
