0 1 2 0 0 0 0 0 3 4
0 1 2 0 0 0 5 6 1 2
7 8 9 7 7 7 7 7 10 2
0 0 11 12 13 14 0 15 1 2
0 11 16 17 17 18 14 19 1 2
11 16 20 21 22 23 18 14 1 2
24 25 26 26 26 26 27 28 1 2
0 29 30 31 31 30 32 0 1 2
0 0 33 34 34 33 0 35 1 2
7 7 9 7 7 9 7 7 36 37
